2222222222
1--------1
1---P----12222222222222222
1---------S--------------2
1------1-----1-----------2
222222222222222222222--S-2
1------------------------1
1-------S----------------1
1--------------1111------1
1--------------1---------1
1------S-------1---------1
1--------------1---------1
11111111111111111111111111
